{
  "size_x":  10,
  "size_y":  10,
  "tileset": [
               "tile_texture.png",
               "tile_texture2.png",
               "tile_ceiling.png",
               "tile_house_ground.png"
             ],
  "tilemap": [
               1, 0, 0, 0, 0, 0, 0, 0, 0, 0,
               3, 3, 3, 3, 0, 0, 0, 0, 0, 0,
               3, 3, 3, 3, 0, 0, 0, 0, 0, 0,
               3, 3, 3, 3, 0, 0, 0, 0, 0, 0,
               3, 3, 3, 3, 0, 0, 0, 0, 0, 0,
               0, 0, 0, 0, 0, 0, 0, 1, 0, 0,
               0, 0, 0, 0, 0, 0, 0, 0, 0, 0,
               0, 0, 0, 0, 0, 0, 0, 0, 0, 0,
               0, 0, 0, 0, 0, 1, 0, 0, 0, 0,
               0, 0, 0, 0, 0, 0, 0, 0, 0, 0
             ],

  "ceiling": [
               -, -, -, -, -, -, -, -, -, -,
               2, 2, 2, 2, -, -, -, -, -, -,
               2, 2, 2, 2, -, -, -, -, -, -,
               2, 2, 2, 2, -, -, -, -, -, -,
               2, 2, 2, 2, -, -, -, -, -, -,
               -, -, -, -, -, -, -, -, -, -,
               -, -, -, -, -, -, -, -, -, -,
               -, -, -, -, -, -, -, -, -, -,
               -, -, -, -, -, -, -, -, -, -,
               -, -, -, -, -, -, -, -, -, -
             ],

  "wallset": [
               "wall.png"
             ],
  "hwalls":  [
               0, 0, 0, 0, 0, 0, 0, 0, 0, 0,
               1, 0, 0, 0, 1, 0, 0, 0, 0, 0,
               1, 0, 0, 0, 1, 0, 0, 0, 0, 0,
               1, 0, 0, 0, 1, 0, 0, 0, 0, 0,
               1, 0, 0, 0, 1, 0, 0, 0, 0, 0,
               0, 0, 0, 0, 0, 0, 0, 0, 0, 0,
               0, 0, 0, 0, 0, 0, 0, 0, 0, 0,
               0, 0, 0, 0, 0, 0, 0, 0, 0, 0,
               0, 0, 0, 0, 0, 0, 0, 0, 0, 0,
               0, 0, 0, 0, 0, 0, 0, 0, 0, 0
             ],
  "vwalls":  [
               0, 0, 0, 0, 0, 0, 0, 0, 0, 0,
               1, 1, 1, 1, 0, 0, 0, 0, 0, 0,
               0, 0, 0, 0, 0, 0, 0, 0, 0, 0,
               0, 0, 0, 0, 0, 0, 0, 0, 0, 0,
               0, 0, 0, 0, 0, 0, 0, 0, 0, 0,
               1, 1, 0, 1, 0, 0, 0, 0, 0, 0,
               0, 0, 0, 0, 0, 0, 0, 0, 0, 0,
               0, 0, 0, 0, 0, 0, 0, 0, 0, 0,
               0, 0, 0, 0, 0, 0, 0, 0, 0, 0,
               0, 0, 0, 0, 0, 0, 0, 0, 0, 0
             ]
}
